R 800 600

NO ./texture/north.xpm
SO ./texture/wall.xpm
WE ./texture/wood.xpm
EA ./texture/east.xpm
S ./texture/sprite.xpm

F 153,255,51
C 51,153,255

111111111111111111111111111111
100000000002000000011100000001
10E011100000002000011100020001
100211100002000020011100000001
111111111111111100000000200001
100000000000000000011100000001
101111111111111100011100020001
100000000000000000011100000001
101111111111111111111110111101
100000000000000000100000100101
101111101111111110101110101101
101000000000000000100010101101
101111111111111111111110101101
100000000000000000000000101101
100000200000000200000200101101
100000000000000000000000101101
111111111111111111000111101101
100000000000000000000000000001
111111111111111111111111111111
