R 1600 800

NO ./texture/wood.xpm
SO ./texture/wood.xpm
WE ./texture/wood.xpm
EA ./texture/wood.xpm
S ./texture/barrel.xpm

F 205,133,63
C 80,188,233

111111111111111111111111111111
100000000002000000011100000001
10E011100000002000011100020001
100211100002000020011100000001
111111111111111100000000200001
111111111111111100011100000001
111111111111111100011100020001
100000000000000000011100000001
101111111111111111111110111101
101111111111111111111110111101
101111111111111111111110111101
101111111111111111111110111101
101111111111111111111110111101
100000000000000000000000111101
100000200000000200000200111101
100000000000000000000000111101
111111111111111111000111111101
111111111111111111000000000001
111111111111111111111111111111
